3 13 31 6
###############################
#  p* # 2 # ### #####         #
#  *  #   # #   1 #           #
#     #   # ###   #    3      #
#     #   # #     #           #
#      #*#  ###   #           #
#*#*#*# * # # # # #*# #*# # # #
#*  *  2   *1 *   3  *   3    #
# # # # #*# # # #*#*# # # # # #
#*    **  *   1    *   *  1   #
# #*# # # # # # #*# # # # # # #
#     1     *   ** *   1   *  #
###############################
s 2 3
b 6 1
f 5 8
s 7 14
b 11 16
x 1 4